####################
#    C           #F#
#E                 #
#   C              #
#   W              #
#        C         #
#      E           #
#C                C#
#        W         #
#      C           #
#          E       #
#    C             #
##    W            #
#P               W #
####################